 R 1920 1080
NO ./textures/bluestone.xpm
SO ./textures/colorstone.xpm
WE ./textures/greystone.xpm
EA ./textures/redbrick.xpm
S ./textures/barrel.xpm

 S ./path_to_the_sprite_texture
 F 220,100,0
 C 225,30,0


        1111111111111111111111111          111111111111111
        10000000001100000000000011111111111111100000011111
        10110000011100000020000000000000000111100000011111
        1001000000000000000000001111111111001100000011111
11111111101100000111000000000000111111111110000000000011111
100000000011000001110111011111111          111011110111111
11110111111111011100000000001111111111111111110111101
11110111111111011101010000001111111111100000000111101
110000001101010111000W00000011111111111011111111111011111111111111111111111
100020000000000011000000000200000000000110000000002000000000001100000000001
100000000000000011010100000011111110111111111011111111111111111111100111111
110000011101010111110111000000100000002000000000001100000000020000000000011
11110111 1110101 101111000001000000020000000000010000000000200000000000110100000000
11111111 1111111 11111111111011111111111111111111111111111111111111111111111
