 R 1024 2000
NO ./textures/bluestone.xpm
SO ./textures/colorstone.xpm
WE ./textures/greystone.xpm
EA ./textures/redbrick.xpm
S ./textures/barrel.xpm
 F 220,100,0
 C 225,30,0

111111111111111
100000000000011
111000000010011
100000100000011
101000000000011
1000000111100011
110000000000011
11000020000011
110000200000011
110000200000011
110000000000011
110000000000011
110000000000011
110000000000011
110000000000011
110000000000011
110000000000011
110000000000011
110000000000011
110000000000011
110000000000011
110000000000011
100000E00010011
111111111111111
