R 640 640

NO ./textures/bluestone.xpm
SO ./textures/colorstone.xpm
WE ./textures/greystone.xpm
EA ./textures/redbrick.xpm
S ./textures/barrel.xpm

F 117, 255, 0
C 135, 245, 251

111111111111111111111
10000000000S000000001
100000000000000000001
100000000000000000001
100012220000000000001
100012220000000000001
100012220000000000001
111111111111111111111
