R 640 640

NO ./textures/kadhafi.xpm
SO ./textures/trump.xpm
WE ./textures/kim.xpm
EA ./textures/macron.xpm
S ./textures/barrel.xpm

F 117, 255, 0
C 135, 245, 251

11111111
10200001
10000001
10000001
10N01001
10001001
10001001
11111111
