 R 500 700
NO ./textures/colorstone.xpm
SO ./textures/colorstone.xpm
WE ./textures/greystone.xpm
EA ./textures/redbrick.xpm
S ./textures/barrel.xpm

 S ./path_to_the_sprite_texture
 F 25,10,10
 C 255,255,255

11111
1S001
10001
10001
11111
