R 640 640

NO ./textures/bluestone.xpm
SO ./textures/colorstone.xpm
WE ./textures/greystone.xpm
EA ./textures/redbrick.xpm
S ./textures/barrel.xpm

F 117, 255, 0
C 135, 245, 251

1111111111
1000000001
1111000001
1000000001
1000001001
1020001021
100000100111111111
111111100000000001
      100000000001
      100000000001
      10S001110111
      100001200001
      100001000001
      111111111111
