 R 100 120
 NO ./path_to_the_north_texture
 SO ./path_to_the_south_texture
 WE ./path_to_the_west_texture
 EA ./path_to_the_east_texture

 S ./path_to_the_sprite_texture
 F 220,100,0
 C 225,30,0
1 1111111111111111
1N00011110010101001
1000000000000000001
1111111111111111111
