R 640 640

NO ./textures/bluestone.xpm
SO ./textures/colorstone.xpm
WE ./textures/greystone.xpm
EA ./textures/redbrick.xpm
S ./textures/barrel.xpm

F 117, 255, 0
C 135, 245, 251

11111111
12200001
12020001
10000001
10021001
102N1021
10221001
11111111
