R 640 640

SO ./textures/kadhafi.xpm
NO ./textures/trump.xpm
EA ./textures/kim.xpm
WE ./textures/macron.xpm
S ./textures/pillar.xpm

F 117, 255, 0
C 135, 245, 251

111111111111111111111
100000000000000000001
1000000000000000000W1
100000000000000000001
100012220000000000001
100012220000000000001
100012220000000000001
111111111111111111111
