R 100 100

NO ./textures/bluestone.xpm
SO ./textures/colorstone.xpm
WE ./textures/greystone.xpm
EA ./textures/redbrick.xpm
S ./textures/barrel.xpm

F 117, 255, 0
C 135, 245, 251

11
11111
11001
10N01
10001
11111111111
