 R 100 120
 NO ./path_to_the_north_texture
 SO ./path_to_the_south_texture
 WE ./path_to_the_west_texture
 EA ./path_to_the_east_texture

 S ./path_to_the_sprite_texture
 F 220,100,0
 C 225,30,0


111111111111111
100000000000011
10000000W000011
100000000000011
100000000000011
100000000000011
100000000000011
100000000000011
101111111111111
111111111111111
