 R 1920 1080
 NO ./path_to_the_north_texture
 SO ./path_to_the_south_texture
 WE ./path_to_the_west_texture
 EA ./path_to_the_east_texture

 S ./path_to_the_sprite_texture
 F 220,100,0
 C 225,30,0


        1111111111111111111111111          111111111111111
        1000000000110000000000001          111100000011111
        1011000001110000002000001          111100000011111
        1001000000000000000000001          111100000011111
111111111011000001110000000000001          111100000011111
100000000011000001110111011111111          111111111111111
11110111111111011100000000001
11110111111111011101010000001
110000001101010111000W0000001
10002000000000001100000000001
10000000000000001101010000001
1100000111010101111101110000111
11110111 1110101 101111000001
11111111 1111111 111111111111
